Super Fields
15 32
162 162 851 852 853 162 599 606 629 720 162 162 29 212 212 212 212 212 212 212 212 212 24 162 162 162 162 162 162 25 212 212
162 162 883 884 885 162 162 632 807 808 809 162 93 212 212 212 212 212 212 212 212 24 162 162 162 162 162 162 162 720 25 212
162 162 915 916 917 162 162 2 871 162 873 162 27 212 212 212 212 212 87 212 24 162 162 162 162 932 720 162 720 162 57 212
162 162 162 162 162 162 162 600 162 162 162 720 59 212 212 84 86 24 162 25 56 162 720 162 162 162 116 117 118 57 212 212
162 162 162 162 162 720 162 632 720 162 162 57 212 212 24 162 162 162 162 57 212 56 720 162 116 57 212 212 212 212 212 212
162 720 162 932 162 162 162 600 162 162 162 25 212 212 95 162 162 162 162 25 157 87 63 865 212 26 27 212 212 212 212 212
529 162 162 162 162 162 162 2 162 162 162 162 25 212 95 162 804 162 162 162 30 162 162 162 25 56 162 27 212 212 212 212
617 162 162 162 162 162 162 600 162 162 162 162 162 2 162 162 162 162 162 162 2 162 162 162 94 212 56 57 212 212 212 212
425 529 631 570 571 865 570 634 865 570 630 162 162 600 162 162 162 631 538 571 598 162 162 162 162 125 212 212 212 212 212 212
425 465 600 162 162 162 162 162 162 162 600 162 162 600 162 720 162 632 162 162 162 162 162 162 162 125 212 212 212 212 212 212
425 592 600 373 162 162 162 162 900 162 2 162 162 2 162 162 162 2 162 162 162 162 162 162 57 212 212 212 212 212 212 212
571 571 598 617 529 162 162 162 162 162 600 162 720 632 162 162 162 632 162 804 162 162 162 57 212 212 212 212 212 212 212 212
752 524 524 617 615 373 720 804 162 162 599 570 571 634 570 571 865 634 630 162 162 162 162 29 212 212 212 212 212 212 212 212
524 524 524 617 614 617 581 616 529 162 162 742 742 742 742 742 742 162 600 162 162 162 162 61 212 84 85 86 212 212 212 212
524 524 524 617 614 617 460 460 492 529 384 616 581 616 581 523 616 529 600 162 162 162 162 93 26 162 162 162 25 212 212 212
