Super Fields
22 32
679 679 131 131 679 679 679 679 679 679 679 679 679 679 679 679 679 679 581 715 525 525 525 525 525 523 523 523 523 523 523 523
679 679 679 131 131 679 679 679 679 679 679 679 679 679 679 679 679 679 432 684 684 559 715 715 715 715 525 524 524 523 523 523
679 679 679 131 131 679 679 679 679 679 679 679 679 679 679 679 679 679 131 131 131 684 684 684 684 684 525 525 525 524 523 523
679 679 684 131 900 131 679 679 679 679 679 720 131 720 131 131 131 131 720 932 131 131 131 131 131 720 684 684 525 525 524 523
679 684 684 131 131 131 131 679 131 720 131 131 720 131 720 679 679 679 679 131 131 131 749 750 131 131 684 684 463 525 524 524
679 684 684 720 131 684 684 131 131 679 679 679 679 679 131 679 679 679 684 131 131 131 131 684 679 131 131 684 463 525 524 524
679 684 720 131 720 131 131 131 684 679 679 679 679 679 679 679 679 684 131 131 131 131 131 131 684 679 131 684 559 525 525 524
679 684 720 851 852 853 684 679 679 679 679 679 679 679 679 679 679 684 684 131 131 932 131 131 131 679 131 131 684 559 525 525
679 684 131 883 884 885 720 684 679 679 679 679 679 679 679 679 679 684 684 684 131 131 131 131 720 591 385 745 131 684 463 525
679 684 131 915 916 917 131 720 684 679 679 679 679 679 679 679 679 679 679 684 684 720 720 720 720 495 481 497 131 684 463 525
679 684 720 131 131 131 131 131 131 679 679 679 679 679 679 679 679 679 679 679 679 679 720 720 591 524 425 528 131 684 463 525
679 684 131 131 131 131 131 720 684 684 679 679 679 679 679 679 679 679 679 679 679 679 679 679 679 679 679 528 131 684 463 525
679 684 720 131 131 131 131 720 684 679 679 679 679 679 679 679 810 811 812 679 679 679 679 679 679 679 492 592 131 684 463 525
679 684 684 720 131 131 131 684 679 679 679 679 679 131 684 684 842 843 844 131 804 679 679 679 679 679 592 131 131 131 463 525
679 679 684 684 131 131 131 684 679 679 679 684 804 131 684 131 684 131 131 131 131 684 652 653 684 131 131 131 932 131 559 525
679 679 131 720 131 131 131 749 750 684 684 131 684 131 131 131 131 131 932 131 131 131 131 131 131 131 131 131 131 131 131 463
679 679 679 679 679 932 749 750 684 131 131 131 131 131 131 131 131 131 131 131 131 932 131 131 131 131 131 131 131 131 131 559
679 679 679 679 131 131 131 131 131 131 131 804 131 131 131 131 131 782 783 131 131 131 131 131 131 131 131 131 131 131 131 131
679 679 679 679 131 131 131 131 131 131 131 131 131 131 131 131 131 720 131 131 131 679 131 131 131 131 131 131 131 131 131 131
679 679 679 679 679 679 131 131 131 131 131 131 131 131 131 131 131 131 131 679 679 679 679 679 131 720 131 131 131 131 131 131
679 679 679 679 679 679 679 679 131 131 131 131 131 131 131 131 131 131 679 679 679 679 679 679 131 131 720 131 131 131 131 131
679 679 679 679 679 679 679 679 679 679 679 679 679 679 679 679 679 679 679 679 679 679 679 679 679 131 131 131 131 131 131 131
