FE5 Fields
30 16
591 693 1 130 66 1 1 1 1 1 1 1 646 672 685 524
591 591 693 166 135 1 1 1 1 1 1 1 1 646 683 524
591 591 718 162 877 74 74 74 65 66 129 1 1 1 672 683
591 718 709 1 97 64 64 64 64 64 64 66 1 879 646 646
695 709 709 1 1 97 105 64 64 64 64 98 1 646 646 672
695 709 1 646 1 709 65 64 878 646 64 66 1 1 646 556
695 709 646 1 646 65 105 98 646 646 64 105 66 646 672 684
695 709 646 1 168 64 709 646 65 75 98 672 97 66 1 684
695 709 1 65 73 64 73 75 98 1 556 698 552 1018 552 684
695 709 1 134 64 64 135 646 1 556 396 695 296 360 1 684
695 709 646 134 64 105 98 1 556 524 396 695 358 360 1 684
695 709 1 134 64 131 1 646 684 396 396 695 1 426 427 653
695 709 646 97 64 167 1 556 433 622 569 687 1 390 1 1
695 709 1 646 97 163 1 684 462 689 1 1 928 929 930 1
633 693 709 709 1 1 672 684 462 689 696 1 992 993 994 1
633 689 1 646 1 1 1 683 567 568 462 694 1 390 728 696
633 591 693 709 709 1 1 1 709 646 566 597 627 396 396 462
633 591 686 672 709 1 1 1 646 1 646 646 683 396 396 494
633 689 709 709 1 1 1 65 73 73 66 646 646 653 619 396
403 876 1 709 709 709 65 64 64 64 64 73 66 1 646 684
462 689 1 1 709 709 877 646 64 64 64 64 98 1 646 684
462 591 693 1 1 1 97 105 64 64 64 646 1 611 612 684
462 591 718 1 1 1 1 646 97 64 64 64 66 643 644 684
462 699 1 672 709 1 646 1 65 64 64 64 98 646 556 524
462 699 646 1 1 1 1 1 160 97 646 98 1 672 684 524
462 699 646 646 646 1 1 1 1 934 956 936 1 1 908 524
396 430 693 646 877 646 1 1 1 966 988 968 1 1 684 524
396 495 591 693 646 646 1 1 646 998 999 1000 646 1 683 524
396 396 430 654 462 693 646 646 1 1 548 646 1 646 1 684
396 396 495 656 462 591 693 672 646 514 512 515 1 646 556 524
